07 64 99 64 03 09 09 07 01 99 64 99 19 66 19 64 19 99 19 03
07 62 96 62 03 09 09 07 62 62 62 62 62 62 62 62 62 62 62 03
07 60 61 60 03 09 09 07 60 61 60 61 60 61 60 61 60 61 48 03
04 00 00 00 06 11 11 04 00 00 00 00 00 00 00 00 00 00 40 06
33 00 00 00 01 99 24 01 00 00 00 00 00 00 00 00 00 61 00 37
34 00 05 05 44 44 44 44 43 00 00 00 00 00 97 00 00 60 00 36
35 15 15 15 46 46 46 47 15 15 15 15 15 15 15 15 15 15 15 38
12 12 12 12 12 21 12 12 12 12 12 12 21 12 12 12 12 12 12 21
09 09 09 09 09 09 09 09 09 09 09 09 09 09 09 09 09 09 09 09
09 09 09 09 09 09 09 09 09 09 09 09 09 09 09 09 09 09 09 09
09 09 09 09 09 09 09 09 09 09 09 09 09 09 09 09 09 09 09 09
09 09 09 09 09 09 09 09 09 09 09 09 09 09 09 09 09 09 09 09