07 20 57 20 03 09 09 07 99 58 99 23 24 22 24 23 99 22 99 03
07 62 62 62 03 09 09 07 62 62 62 62 62 62 62 62 62 62 63 03
07 60 61 60 03 09 09 07 61 60 60 61 60 61 60 61 60 61 60 03
04 00 00 00 06 11 11 04 00 00 00 00 00 00 00 00 00 00 00 06
33 98 00 00 01 20 20 01 00 00 00 00 00 00 00 00 00 61 00 37
34 00 05 05 44 44 44 44 43 97 00 00 00 00 00 00 00 60 00 36
35 00 05 05 46 46 46 47 43 00 00 00 00 61 60 00 00 60 00 36
13 98 05 00 14 21 21 13 00 05 00 00 00 60 00 00 00 00 00 36
07 40 05 00 03 09 09 07 00 05 00 00 00 00 00 00 00 00 00 38
07 00 00 00 03 09 09 07 61 61 00 00 00 00 00 00 00 00 61 14
07 96 61 61 03 09 09 07 18 61 61 15 15 15 15 15 15 15 15 03
07 15 15 15 03 09 09 07 13 08 08 14 19 12 19 12 19 12 19 03