3 0 0 0 3 9 9 3 0 0 0 0 3 3 3 3 0 0 3 3
3 0 0 0 3 9 9 3 0 0 0 0 5 0 0 0 0 0 0 3
3 0 0 0 3 9 9 3 0 0 0 0 5 0 0 0 0 0 0 3
3 0 0 0 3 9 9 3 0 0 0 0 5 0 0 0 0 0 0 0
3 0 0 0 3 3 3 3 0 0 0 0 5 0 0 0 0 0 0 0
0 0 0 0 0 0 0 0 0 0 0 0 0 0 0 0 0 0 0 0
0 0 0 0 0 0 0 0 0 0 0 0 0 0 0 0 0 0 0 0
3 0 0 0 7 3 3 6 0 0 0 0 5 0 0 0 0 0 0 0
3 0 0 0 3 9 9 3 0 0 0 0 5 0 0 0 0 0 0 0
3 0 0 0 3 9 9 3 0 0 0 0 5 0 0 0 0 0 0 3
3 0 0 0 3 9 9 3 0 0 0 0 5 0 0 0 0 0 0 3
3 3 3 3 3 9 9 3 0 0 0 0 3 3 3 3 3 3 3 3