09 09 09 09 09 09 09 09 09 09 09 09 09 09 09 09 09 09 09 09
09 09 09 09 09 09 09 09 09 09 09 09 09 09 09 09 09 09 09 09
09 09 09 09 09 09 09 09 09 09 09 09 09 09 09 09 09 09 09 09
11 11 11 11 11 11 11 11 11 11 11 11 11 11 11 11 11 11 11 11
33 19 01 99 01 19 01 19 01 99 01 19 01 19 01 99 01 19 01 14
94 60 61 60 44 44 44 44 43 05 05 60 61 60 05 97 96 60 61 14
95 15 15 15 46 46 46 47 15 15 15 15 15 15 15 15 15 15 15 14
12 12 12 12 12 22 12 12 12 12 12 12 22 12 12 12 12 12 12 12
09 09 09 09 09 09 09 09 09 09 09 09 09 09 09 09 09 09 09 09
09 09 09 09 09 09 09 09 09 09 09 09 09 09 09 09 09 09 09 09
09 09 09 09 09 09 09 09 09 09 09 09 09 09 09 09 09 09 09 09
09 09 09 09 09 09 09 09 09 09 09 09 09 09 09 09 09 09 09 09