09 09 09 09 09 09 09 09 09 09 09 09 09 09 09 09 09 09 09 09
09 09 09 09 09 09 09 09 09 09 09 09 09 09 09 09 09 09 09 09
09 09 09 09 09 09 09 09 09 09 09 09 09 09 09 09 09 09 09 09
11 11 11 11 11 11 11 11 11 11 11 11 11 11 11 11 11 11 11 11
33 19 01 99 01 19 01 19 01 99 01 19 01 19 01 99 01 19 01 37
34 60 61 60 44 44 44 44 43 05 05 60 61 60 05 05 05 60 61 36
35 15 15 15 46 46 46 47 15 15 15 15 15 15 15 15 15 15 15 38
12 12 12 12 12 22 12 12 12 12 12 12 22 12 12 12 12 12 12 22
09 09 09 09 09 09 09 09 09 09 09 09 09 09 09 09 09 09 09 09
09 09 09 09 09 09 09 09 09 09 09 09 09 09 09 09 09 09 09 09
09 09 09 09 09 09 09 09 09 09 09 09 09 09 09 09 09 09 09 09
09 09 09 09 09 09 09 09 09 09 09 09 09 09 09 09 09 09 09 09