09 09 09 09 09 09 09 07 99 58 99 23 24 22 24 23 99 22 99 03
09 09 09 09 09 09 09 07 62 62 62 62 62 62 62 62 62 62 63 03
09 09 09 09 09 09 09 07 61 60 00 00 60 00 00 61 00 61 05 03
11 11 11 11 11 11 11 04 00 00 00 00 00 00 00 00 00 00 00 06
33 19 01 99 01 22 22 99 00 00 00 00 00 00 00 00 00 61 00 37
34 00 05 05 44 44 44 44 43 00 00 00 00 00 00 00 00 60 00 36
35 00 05 05 46 46 46 47 43 00 00 00 00 61 60 00 00 60 00 36
13 00 05 00 14 12 12 13 00 05 00 00 00 60 00 00 00 00 00 36
07 00 05 00 03 09 09 07 00 05 00 00 00 00 00 00 00 00 00 38
07 40 05 00 03 09 09 07 61 61 00 00 00 00 00 00 00 00 61 14
07 48 40 00 03 09 09 07 18 61 61 15 15 15 15 15 15 15 15 03
07 15 15 15 03 09 09 07 13 08 08 14 19 12 19 12 19 12 19 03