07 22 99 22 03 09 09 07 22 58 22 99 19 22 19 22 19 99 19 03
07 62 96 62 03 09 09 07 62 62 62 62 62 62 62 62 62 62 00 03
07 60 61 60 03 09 09 07 48 60 00 00 60 00 00 61 00 61 05 03
04 00 00 00 06 11 11 04 40 00 00 00 00 00 00 00 00 00 00 06
33 00 00 00 01 20 20 01 48 00 00 00 00 00 00 00 00 61 00 37
34 00 05 05 44 44 44 44 43 97 00 00 00 00 00 00 00 60 00 36
35 15 15 15 46 46 46 47 43 00 00 00 00 61 60 00 00 60 00 36
12 21 19 12 19 12 21 13 00 05 00 00 00 60 00 00 00 00 00 36
09 09 09 09 09 09 09 07 00 05 00 00 00 00 00 00 00 00 00 38
09 09 09 09 09 09 09 07 15 15 15 15 15 15 15 15 15 15 15 14
09 09 09 09 09 09 09 07 12 19 12 19 12 19 12 19 12 19 12 03
09 09 09 09 09 09 09 07 19 12 19 12 19 12 19 12 19 12 19 03