07 20 10 20 03 09 09 07 99 10 99 19 01 22 01 19 99 10 99 03
07 00 00 00 03 09 09 07 00 00 00 00 00 00 00 00 00 00 00 03
07 00 00 00 03 09 09 07 00 00 00 00 00 00 00 00 00 00 00 03
04 00 00 00 06 11 11 04 00 00 00 00 00 00 00 00 00 00 00 06
33 98 00 00 01 23 24 01 00 00 00 00 00 00 00 00 00 00 00 37
34 00 00 00 44 44 44 44 43 00 00 00 00 00 00 00 00 00 00 36
35 00 00 00 46 46 46 47 43 00 00 00 00 00 00 00 00 00 00 36
13 98 00 00 14 21 21 13 00 00 00 00 00 00 00 00 00 00 00 36
07 00 00 00 03 09 09 07 00 00 00 00 00 00 00 00 00 00 00 38
07 00 00 00 03 09 09 07 98 00 00 00 00 00 00 00 00 00 98 14
07 48 00 40 03 09 09 07 18 00 00 15 15 15 15 15 15 15 15 03
07 15 15 15 03 09 09 07 13 08 08 14 19 12 19 12 19 12 19 03